wrath = combat focus damage, more damage
greed = focusing targets, high speed
lust = utility,buffs and debuffs
gluttony = gain with enemy losses, self heal
envy = enemy weakening, enemy debuff
pride = empowerment self buff
sloth = defensive, team buffing

patience
charity
chastity
temperance
kindness
humility
diligence

t1
orcs : wrath > gluttony : melee bruisers 
goblins : greed > lust : fast fighters
zombie : gluttony > envy: self healing and debuffs
skeleton : sloth > wrath: balanced melee
imp : envy : mage > greed : mage, damage
dark fae : lust > pride : mage, debuff
shades : envy - wrath > lust : fast assasins


t2
arachnids : sloth - gluttony  > wrath, range/melee heals and debuffs
hellhounds : pride - gluttony > greed: high damage
hobgoblins : greed - lust > gluttony : balanced fighters
golems : sloth - wrath
black knights :pride wrath > greed lust ~ diligence: powerful vangaurds
banshees : envy - wrath > lust pride ~ charity : ranged with debuffs
succubus : lust - sloth > wrath greed ~ kindness : ranged debuffer/buffer














